seconds_from_midnight,n_adults,n_children
0,0,0
3600,0,0
7200,0,0
10800,0,0
14400,0,0
18000,0,0
21600,0,0
25200,3,2
28800,0,0
32400,0,0
36000,0,0
39600,0,0
43200,0,0
46800,1,3
50400,0,0
54000,0,0
57600,0,0
61200,0,0
64800,0,0
68400,0,0
72000,0,0
75600,0,0
79200,0,0
82800,0,0
