seconds_from_midnight,n_adults,n_children
0,1,0
3600,1,0
7200,1,0
10800,1,0
14400,1,0
18000,1,0
21600,1,0
25200,1,0
28800,1,0
32400,2,1
36000,2,1
39600,2,1
43200,0,0
46800,0,0
50400,1,2
54000,1,2
57600,1,2
61200,0,0
64800,0,0
68400,0,0
72000,1,0
75600,1,0
79200,1,0
82800,1,0
